找到从入口到出口的路径: 
S # * * * 
* # * # * 
* # * # * 
* * * # * 
. # . # E 
